Xue, Xue, Xue, Xue, Xue, Xue, Xue, Xue, Xue, Xue, Xue, Xue, Xue, Xue, Xue, Xue, Xue, Xue, Xue, Xue, Xue, Xue, Xue, Xue, Xue, Xue, Xue, Xue, Xue, Xue, Xue
Xue, Xue, Xue, Xue, Xue, Xue, Xue, Xue, Xue, Xue, Xue, Xue, Xue, Xue, Xue, Xue, Xue, Xue, Xue, Xue, Xue, Xue, Xue, Xue, Xue, Xue, Xue, Xue, Xue, Xue, Xue
Xue, Xue, Xue, Xue, Xue, Xue, Xue, Xue, Xue, Xue, Xue, Xue, Xue, Xue, Xue, Xue, Xue, Xue, Xue, Xue, Xue, Xue, Xue, Xue, Xue, Xue, Xue, Xue, Xue, Xue, Xue
Xue, Xue, Xue, Xue, Xue, Xue, Xue, Xue, Xue, Xue, Xue, Xue, Xue, Xue, Xue, Xue, Qlf, Xue, Xue, Xue, Xue, Xue, Xue, Xue, Xue, Xue, Xue, Xue, Xue, Xue, Xue
Xue, Xue, Xue, Xue, Xue, Xue, Xue, Xue, Xue, Xue, Xue, Xue, Xue, Xue, Xu, Qlf, Qlf, Qlf, Qlf, Xue, Cud, Xue, Cud, Xue, Xue, Xue, Xue, Xue, Xue, Xue, Xue
Xue, Xue, Xue, Xue, Xue, Xue, Xue, Xue, Xue, Xue, Ur^Edb, Ur, Qlf, Qlf, Xu, Xu, Qlf, Qlf, Qlf, Uu, 1 Kud, Cud, Cud, Cud, Xue, Xue, Xue, Xue, Xue, Xue, Xue
Xue, Xue, Xue, Xue, Xue, Xue, Xue, Xue, Uu^Uf, Ur^Edb, Ur^Edb, Ur, Qlf, Qlf, Ql, Xue, Xu, Ql, Ql, Uu, Uu, Cud, Uu, Cud, Qlf, Xue, Xue, Xue, Xue, Xue, Xue
Xue, Xue, Xue, Xue, Xue, Xue, Uu^Uf, Uu^Uf, Ur, Ur^Edb, Ur, Qlf, Qlf, Qlf, Ql, Ql, Ql, Ql, Uu, Uu, Urb, Uu, Uh, Qlf, Xu, Xu, Uh, Xue, Xue, Xue, Xue
Xue, Xue, Xue, Xue, Xue, Xue, Uu^Uf, Uu^Uf, Qlf, Ur, Ur, Qlf, Ur^Edt, Qlf, Uue, Uue, Ur, Ql, Uu^Edb, Uu, Urb, Ql, Ql, Qlf, Xu, Xu, Uh, Qlf, Qlf, Xue, Xue
Xue, Xue, Xue, Xue, Xue, Uu^Uf, Ur, Qlf, Qlf, Qlf, Ql, Ur^Edt, Ql, Ur, Uue, Ql, Uu^Ii, Uu, Xu, Urb, Uue, Ql, Ql, Xu, Qlf, Uh, Ur^Es, Qlf, Qlf, Xue, Xue
Xue, Xue, Xue, Xue, Uh, Uh, Qlf, Qlf, Xue, Qlf, Ql, Ql, Ql, Ql, Ur^Es, Ql, Uu^Ii, Xu, Xu, Xu, Ql, Uu^Uf, Ql, Ql, Qlf, Ur, Qlf, Uh, Qlf, Xue, Xue
Xue, Xue, Xue, Xue, Uh, Uh, Qlf, Xue, Qlf, Qlf, Xue, Xue, Ql, Ql, Uu, Uu^Es, Urb^Es, Urb^Ii, Xu, Xue, Uue, Uue, Ur^Edb, Ql, Ur, Ur, Qlf, Ur^Edt, Ur^Edt, Xue, Xue
Xue, Xue, Xue, Xue, Xue, Uh, Xue, Xue, Xue, Xue, Qlf, Ql, Ql, Uu, Uu, Urb^Es, Ql, Uu^Ufi, Uu^Ufi, Uue, Ql, Uh, Uh, Ur, Ur, Qlf, Qlf, Ur^Edt, Ur, Xue, Xue
Xue, Xue, Xue, Xue, Xue, Xue, Xue, Xue, Qlf, Xue, Qlf, Ql, Uu, Uu, Urb, Urb, Ql, Ql, Ql, Ql, Ql, Ql, Ql, Ql, Uu^Uf, Ur, Uu^Uf, Uh, Xue, Xue, Xue
Xue, Xue, Xue, Xue, Xue, Xue, Qlf, Qlf, Qlf, Qlf, Urb^Edt, Urb^Edt, Urb^Edt, Urb, Qlf, Qlf, Qlf, Ql, Xu, Xu, Ql, Ql, Qlf, Qlf, Uu^Uf, Uu^Uf, Uu^Uf, Uu^Uf, Xue, Xue, Xue
Xue, Xue, Xue, Xue, Xue, Qlf, Cud, Cud, Cud, Ur, Uu, Uu, Qlf, Qlf, Xue, Xue, Xue, Qlf, Xu, Xu, Qlf, Qlf, Xue, Qlf, Uu^Uf, Uu^Uf, Xue, Xue, Xue, Xue, Xue
Ur, Xue, Xue, Xue, Ur, Cud, Cud, 2 Kud, Cud, Ur, Ur, Xue, Xue, Xue, Xue, Xue, Xue, Xue, Xue, Xu, Xue, Xue, Xue, Xue, Xue, Xue, Xue, Xue, Xue, Xue, Xue
Xue, Ur, Ur, Ur, Xue, Xue, Xue, Xue, Xue, Cud, Xue, Xue, Xue, Xue, Xue, Xue, Xue, Xue, Xue, Xue, Xue, Xue, Xue, Xue, Xue, Xue, Xue, Xue, Xue, Xue, Xue
Xue, Xue, Xue, Xue, Xue, Xue, Xue, Xue, Xue, Xue, Xue, Xue, Xue, Xue, Xue, Xue, Xue, Xue, Xue, Xue, Xue, Xue, Xue, Xue, Xue, Xue, Xue, Xue, Xue, Xue, Xue
Xue, Xue, Xue, Xue, Xue, Xue, Xue, Xue, Xue, Xue, Xue, Xue, Xue, Xue, Xue, Xue, Xue, Xue, Xue, Xue, Xue, Xue, Xue, Xue, Xue, Xue, Xue, Xue, Xue, Xue, Xue
Xue, Xue, Xue, Xue, Xue, Xue, Xue, Xue, Xue, Xue, Xue, Xue, Xue, Xue, Xue, Xue, Xue, Xue, Xue, Xue, Xue, Xue, Xue, Xue, Xue, Xue, Xue, Xue, Xue, Xue, Xue
Xue, Xue, Xue, Xue, Xue, Xue, Xue, Xue, Xue, Xue, Xue, Xue, Xue, Xue, Xue, Xue, Xue, Xue, Xue, Xue, Xue, Xue, Xue, Xue, Xue, Xue, Xue, Xue, Xue, Xue, Xue
Xue, Xue, Xue, Xue, Xue, Xue, Xue, Xue, Xue, Xue, Xue, Xue, Xue, Xue, Xue, Xue, Xue, Xue, Xue, Xue, Xue, Xue, Xue, Xue, Xue, Xue, Xue, Xue, Xue, Xue, Xue
Xue, Xue, Xue, Xue, Xue, Xue, Xue, Xue, Xue, Xue, Xue, Xue, Xue, Xue, Xue, Xue, Xue, Xue, Xue, Xue, Xue, Xue, Xue, Xue, Xue, Xue, Xue, Xue, Xue, Xue, Xue
