Ss, Mm, Mm, Mm, Ww, Ww, Ww, Ww, Ww, Ss, Ss, Ww, Ww, Ww, Ww, Hh, Ww, Ww, Ww, Ww, Ss, Ss, Ss, Ww, Ww, Ww, Mm, Hh, Mm, Mm, Mm, Mm
Ss, Hh, Ww, Ww, Ww, Hh, Ww, Ww, Ww, Gs^Fp, Gs^Fp, Gs^Fp, Ww, Ww, Ww, Hh, Hh, Ww, Ww, Ww, Ww, Ww, Ww, Ww, Mm, Ww, Mm, Mm, Mm, Mm, Mm, Mm
Ss, Ss, Ww, Hh, Hh, Ww, Ss, Ss^Vhs, Ww, Ww, Ww, Ww, Ww, Ww, Ww, Hh, Hh, Hh, Hh, Ww, Hh, Hh, Hh, Mm, Mm, Mm, Mm, Mm, Mm, Mm, Mm, Ww
Gs^Fp, Ss, Ww, Ss, Ss, Ss, Ss, Ss, Ss, Ss, Ww, Ww, Ww, Ww, Gs^Fp, Hh, Hh, Hh, Hh, Hh, Ss, Hh, Mm, Mm, Mm, 3 Mv, Mm, Mm, Mm, Mm, Mm, Ww
Gs^Fp, Gs^Fp, Ww, Ss, Ss, Ss, Ss, Gs^Fp, Ww, Ww, Ww, Ww, Ww, Gs^Fp, Gs^Fp, Hh, Ww, Hh, Hh, Hh, Ww^Bw/, Mm, Hh, Mm, Mm, Mm, Mm, Mm, Mm, Hh, Ww, Ww
Ww, Ww, Ss, Ss, Ss, Ss, Gs^Fp, Gs^Fp, Ww, Ww, Ss, Ww, Ww, Ss, Ww, Ww, Ww, Ww, Ww, Re, Gg, Ss, Ss, Hh, Hh, Hh, Hh, Mm, Ww, Ww, Hh, Hh
Ww, Ww, Ss, Ch, Ch, Ch, Gg^Ve, Gs^Fp, Ss, Ww, Ww, Ww, Ww, Ww, Ww, Ww, Ww, Ww, Ww, Ww^Bw|, Ss, Ss, Ss, Ss, Ss, Hh, Hh, Hh, Ww, Ww, Gg, Ww
Ww, Ss, Ss, Ch, 2 Kh, Ch, Gs^Fp, Gs^Fp, Ss, Ww, Ss, Hh, Ww, Gs^Fp, Ww, Ww, Ss, Gg, Re, Ch, Ss, Ss, Ss, Ss, Ss, Hh, Hh, Hh, Ww, Ww, Ss, Ww
Ww, Ww, Ch, Ch, Ch, Ss, Re, Gs^Fp, Ch, Ss, Hh, Hh, Ww, Ww, Gs^Fp, Ss, Ww^Bw/, Re, Gg, Ss, Ss, Ss, Ss, Ss, Ss, Ss, Hh, Ww, Ww, Ww, Ss, Ss
Ss, Ww, Ss, Ss, Ss, Ch, Ss, Re, Ss, Ch, Ss, Hh, Hh, Ww, Ww, Ch, Ss, Ss, Ww, Ww, Ss, Ss, Ss, Ss, Ss, Ss, Hh^Vhh, Ww, Ww, Ww, Ss, Ss
Ww, Ww, Ww, Ss, Ss, Ss, Ss, Ss, Ss, Ww^Bw|, Gs^Fp, Gs^Fp, Gs^Fp, Gs^Fp, Gs^Fp, Ww^Bw|, Ww, Ww, Ss, Ww, Ww, Ss, Ss, Ss, Ss, Ww, Ww, Ww, Ss, Ss, Gg, Ss
Ss, Ww, Ss, Ss, Ss, Gg, Ss, Ss, Ss, Ch, Ww^Bw\, Gs^Fp, Re, Gs^Fp, Re, Re, Gs^Fp, Ww, Ss, Ss, Ww, Gg, Gg, Ss, Ss, Ww, Ww, Ww, Ss, Ss, Ss, Gg
Ss, Ss, Ss, Ss, Ss, Ss, Ch, Ss, Ww^Bw/, Ww^Bw/, Ww, Re, Gs^Fp, Re, Gs^Fp, Gs^Fp, Gg^Ve, Gs^Fp, Gs^Fp, Ss, Ww, Ww, Gg, Gg, Ss, Ss, Ss, Ss, Ss, Ss, Ss, Gg
Gg, Gg, Re, Ww, Ww^Bw/, Ww^Bw/, Ss, Re, Gg, Ss, Ww, Ww, Gs^Fp, Re, Re, Gs^Fp, Ww, Gs^Fp, Gs^Fp, Ss, Ww, Ww, Ww, Gg, Ss, Ss, Ss, Ss, Ss, Gs^Fp, Ss, Ss
Gg, Re, Gg, Ch, Ww, Hh, Hh, Gg, Gg, Ss, Ww, Ww, Ww, Ww, Ww^Bw|, Ww, Ww, Ww, Gs^Fp, Ww, Ww, Ww, Ww, Gg, Ww, Ss, Ss, Ss, Ss, Gs^Fp, Gs^Fp, Ss
Gg, Re, Gg, Ww, Mm, Ww, Ww, Gg, Ww, Ww, Ww, Gs^Fp, Ww, Ss, Ww^Bw|, Ss, Ww, Ww, Ww, Ww, Ww, Gg, Ww, Ww, Ww, Ss, Ss, Ss, Ss, Gs^Fp, Gs^Fp, Gs^Fp
Re, Re, Gg, Ww, Ww, Hh, Hh, Ww, Ww, Ww, Ww, Ww, Ww, Ww, Ww^Bw|, Ss, Ss, Ww, Ss, Ww, Ww, Ss, Ss, Ww, Ww, Hh, Hh, Gs^Fp, Gs^Fp, Gs^Fp, Gs^Fp, Gs^Fp
Gg, Gg, Gg, Hh, Ww, Ww, Ww, Ww, Hh, Ww, Ww, Ww, Ss, Ww, Re, Ss, Hh, Ss, Ss, Ss, Ss, Ss, Ss, Ss^Vhs, Ww, Ww, Ww, Gs^Fp, Gs^Fp, Gs^Fp, Gs^Fp, Gs^Fp
Ww, Ss, Ww, Ww, Ww, Ww, Ww, Ww, Ww, Ww, Hh, Hh, Ss, Hh, Hh, Re, Ss, Gg, Ss, Ss, Ss, Ss, Ss, Ww, Ww, Ww, Ww, Ss, Ss, Gs^Fp, Gs^Fp, Gs^Fp
Ww, Ww, Ww, Ww, Ww, Ww, Hh^Vhh, Ww, Ww, Ww, Mm, Mm, Hh, Ss, Hh, Re, Ch, Ss, Ss, Ss, Ss, Ss, Ss, Ww, Ww, Ww, Ww, Ww, Ww, Gs^Fp, Gs^Fp, Gs^Fp
Ss, Ss, Ww, Gg, Ww, Hh, Mm, Ww, Mm, Mm, Mm, Mm, Mm, Hh, Ss, Ss, Ww^Bw|, Ss, Ss, Ss, Ss, Ss, Ss, Ww, Ww, Ww, Ww, Ww, Ww, Gs^Fp, Gs^Fp, Gs^Fp
Ss, Ss, Ww, Ww, Ww, Ww, Hh, Mm, Mm, Mm, Mm, Mm, Mm, Hh, Hh, Ss, Ww^Bw|, Ss, Ss, Ss, Ss, Ss, Ss, Ss, Ss, Ss, Ww, Ww, Ww, Ww, Gs^Fp, Gs^Fp
Ww, Ss, Ww, Ww, Ww, Ww, Hh, Mm, Mm, Mm, Mm, Mm, Mm, Hh, Hh, Ss, Ch, Ss, Ss, Ss, Ss, Ss, Ww, Ss, Ww, Ss, Ww, Ww, Ww, Ww, Ww, Gs^Fp
Ww, Ww, Ww, Ww, Ww, Ww, Ww, Hh, Mm, Mm, Mm, Mm, Hh, Hh, Ss, Ss^Vhs, Ww, Ww^Bw\, Ch, Re, Ww^Bw\, Ss, Ww, Ww, Ww, Ww, Gs^Fp, Gs^Fp, Gs^Fp, Gs^Fp, Ww, Gs^Fp
Ww, Ww, Ww, Ww, Gs^Fp, Ww, Ss, Ss, Hh, Hh, Mm, Hh, Mm, Hh, Hh, Hh, Ww, Ww, Hh, Hh, Ss, Ww^Bw\, Ww^Bw\, Ww, Ss, Ss, Ss, Gs^Fp, Gs^Fp, Gs^Fp, Ww, Ww
Ss, Ww, Ww, Ss, Gs^Fp, Gs^Fp, Gs^Fp, Gs^Fp, Ss, Ss, Ss, Ss, Ss, Hh, Ww, Ww, Ww, Ww, Ww, Ww, Ww, Ss, Ww, Ww^Bw\, Re, Ss, Ss, Gs^Fp, Gs^Fp, Ww, Gs^Fp, Gs^Fp
Gg, Ss, Ss, Ss, Gs^Fp, Gs^Fp, Ss, Gs^Fp, Gs^Fp, Gs^Fp, Gs^Fp, Gs^Fp, Ww, Ww, Ww, Ss, Ss, Ww, Ww, Ww, Ss, Ss, Ww, Ww, Ww, Re, Ss^Vhs, Ss, Ww, Ww, Gs^Fp, Gs^Fp
Hh, Hh, Hh, Ss, Ss, Ss, Ss, Ss, Gs^Fp, Gs^Fp, Gs^Fp, Gs^Fp, Ww, Ww, Ww, Ww, Ww, Ww, Hh, Hh, Ww, Hh, Hh, Hh, Hh, Ww^Bw|, Ww, Ww, Gs^Fp, Gs^Fp, Gs^Fp, Gs^Fp
Mm, Mm, Hh, Hh, Ss, Ss, Gg, Ss, Gs^Fp, Gs^Fp, Gs^Fp, Ww, Ww, Ww, Ww, Ss, Ss, Ww, Ww, Ww, Hh, Ww, Hh, Hh, Hh, Re, Ss, Ss, Ss, Ss, Gs^Fp, Gs^Fp
Mm, Mm, Mm, Mm, Hh, Hh, Ss, Ss, Gs^Fp, Gg^Ve, Gs^Fp, Gs^Fp, Ww, Ss, Ss, Ww, Ww, Ww, Ww, Ww, Ww, Ww, Mm, Hh, Ss, Ch, Ch, Ch, Ss, Ss, Gs^Fp, Gs^Fp
Mm, Mm, Mm, Mm, Mm, Mm, Hh, Ss, Ss, Ss, Ss, Ss, Ww, Ss, Ss, Ss, Ww, Ww, Ww, Ww, Hh, Mm, Ww, Hh, Ss, Ch, 1 Kh, Ch, Ss, Ss, Gs^Fp, Gs^Fp
Mm, Mm, Mm, Mm, Mm, Mm, Mm, Mm, Hh, Hh, Gg, Gg, Ww, Ww, Gg, Ww, Ww, Ww, Ww, Hh, Hh, Ww, Ww, Ww, Ch, Ch, Ch, Ss, Ss, Ss, Ss, Gs^Fp
Mm, Mm, Mm, Mm, Mm, Mm, Mm, Mm, Mm, Hh, Gg, Gg, Ww, Gg, Gg, Ww, Ww, Ww, Ww, Ss, Ww, Hh, Ww, Ww, Ww, Ww, Ss, Ss, Ss, Ss, Ss, Gs^Fp
Mm, Mm, Mm, Mm, Mm, Mm, Mm, Mm, Mm, Mm, Hh, Hh, Ss, Ww, Ww, Ww, Ss, Ww, Ss, Ss, Ww, Ww, Ww, Ww, Ww, Ww, Ss, Ss, Ss, Ss, Ss, Ww
Mm, Mm, Mm, Mm, Mm, Mm, Mm, Mm, Mm, Mm, Mm, Hh, Ww, Ww, Ww, Ww, Gg^Ve, Ww, Ww, Hh, Ww, Ww, Ww, Ww, Ww, Ss, Ss, Ss, Ss, Ss, Ss, Ww
Mm, Mm, Mm, Mm, Mm, Mm, Mm, Mm, Hh, Hh, Ss, Ss, Ss, Ww, Ss, Ww, Ss, Ww, Hh, Ww, Ww, Ww, Ww, Ww, Ww, Ss, Gg, Gg, Ss, Ss, Ww, Ww
Ww, Mm, Mm, Hh, Hh, Hh, Hh, Hh, Hh, Gg, Ss, Ss, Ss, Ss, Ss, Ss, Ss, Ss, Hh, Ww, Ww, Mm, Mm, Ww, Ww, Ww, Ww, Gg, Ss, Ss, Ww, Ww
Hh, Ww, Ww, Ss, Ss^Vhs, Ss, Ss, Gg, Gg, Gg, Ss, Ss, Ss, Ss, Gs^Fp, Ss, Ss, Ss, Hh, Hh, Mm, Mm, Mm, Hh, Ww, Ww^Vm, Ww, Ww, Ss, Ss, Ss, Ss
Ss, Ss, Ww, Ss, Ss, Ss, Ss, Gg, Gg, Gg, Ss, Ss, Gs^Fp, Gs^Fp, Gs^Fp, Gs^Fp, Ss, Ss, Ss, Hh, Hh, Hh, Hh, Hh, Mm, Ww, Ww, Ww, Ww, Ss, Ss, Ss
Ss, Ss, Ww, Ss, Ss, Ss, Ss, Gg, Gg, Gg, Ss, Ss, Gs^Fp, Gs^Fp, Gs^Fp, Gs^Fp, Gs^Fp, Ss, Hh, Hh, Hh, Ss, Hh, Hh, Hh, Ww, Ww, Ww, Ww, Ss, Ss, Ss
