Aa, Aa, Gg, Gg, Gg, Gg, Gg, Gs^Fp, Ww, Ww, Gs^Fp, Gg, Gg, Gg, Gg, Gg, Ss, Gs^Fp, Gg, Gg, Gs^Fp, Gs^Fp, Gs^Fp, Gs^Fp, Gs^Fp, Gs^Fp, Gs^Fp, Gs^Fp, Gs^Fp, Gs^Fp, Gs^Fp, Gg, Gg, Gg, Gg, Gg, Gg, Gg, Gg, Gg, Gg, Ds
Aa, Aa, Gg, Gg, Gg, Gg, Gs^Fp, Gs^Fp, Ww, Gg, Gg, Gs^Fp, Gg, Gg, Gg, Gg, Gg, Gll^Fmf, Gg, Gg, Gg, Gg, Gg, Gg, Gg^Vh, Gg, Gs^Fp, Gs^Fp, Gs^Fp, Gs^Fp, Gs^Fp, Gg, Aa, Aa, Gg, Gs^Fp, Gg, Gs^Fp, Gs^Fp, Gs^Fp, Ds, Wo
Ha, Ha, Aa, Aa, Ww, Gg^Vh, Ww, Ww, Gg, Gg, Gg, Gg, Aa^Fpa, Gs^Fp, Gg, Gg, Gg, Gg^Fet, Gs^Fp, Gg, Gg, Gg, Aa, Gg, Gg, Gs^Fp, Gs^Fp, Gg, Gg, Gd^Fetd, Gs^Fp, Gg, Aa, Aa, Gg, Gg^Vh, Gs^Fp, Gs^Fp, Ds, Ds, Wo, Wo
Ha, Ai, Ai, Ww, Ww, Ww, Ww, Ww, Gg, Aa, Aa, Aa, Gg, Gs^Fp, Gll^Fmf, Gg, Gs^Fp, Gs^Fp, Gs^Fp, Gg, Gg, Aa, Aa, Gg, Ch, Ch, Ch, Gg, Gg, Gs^Fp, Gg, Gg, Aa, Aa, Gg, Gg, Gg, Ds, Ds, Wo, Wo, Wo
Aa, Ha, Aa, Ww, Ww, Ww, Ww, Gg, Aa, Aa, Aa, Gg, Gg, Gg, Gs^Fp, Gll^Fmf, Gll^Fmf, Gs^Fp, Gg, Gg, Gg, Aa, Aa, Aa, Ch, 1 Kh, Ch, Gs^Fp, Gs^Fp, Gs^Fp, Gg, Gg, Aa, Aa, Ds, Ds, Ds, Ds, Wo, Wo, Wo, Wo
Mm, Mm, Mm, Ww, Ww, Ww, Gg, Gg, Gg^Efm, Aa, Gg^Efm, Gg, Gll^Fmf, Gd^Fetd, Gs^Fp, Gs^Fp, Gs^Fp, Gg, Gg, Gg, Gg, Aa, Aa, Ch, Ch, Ch, Gs^Fp, Ss, Ss, Gs^Fp, Gg, Aa, Aa, Wo, Wo, Wo, Wo, Wo, Wo, Wo, Wo, Wo
Mm, Mm, Ww, Ww, Ww, Ww, Gg, Hh, Gs^Fp, Gg^Efm, Gg^Efm, Gs^Fp, Gs^Fp, Gll^Fmf, Gs^Fp, Gg, Gg, Gg, Gg, Gg, Gg, Gg, Rp, Rp, Ds, Gs^Fp, Ss, Gs^Fp, Ss, Gs^Fp, Ds, Ds, Wo, Wo, Wo, Wo, Wo, Wo, Wo, Wo, Wo, Wo
Mm, Mm, Mm, Ww, Ww, Ww, Hh, Ww, Hh, Gg^Efm, Gg^Efm, Gg, Gs^Fp, Gs^Fp, Gg, Gg, Gg, Aa, Aa, Aa, Aa, Rr, Gg, Wo, Ds, Ds, Ds, Ds, Ds, Ds^Esd, Ds, Wo, Wo, Wo, Wo, Wo, Wo, Wo, Wo, Wo, Wo, Wo
Mm, Mm, Mm, Ww, Ww, Ww, Ww, Ww, Ww, Ww, Gg, Gg, Gs^Fp, Gg, Gg, Gg, Aa, Aa, Gg, Aa, Gg, Rp, Gs^Fp, Ds, Ds, Ds^Esd, Ds, Ds, Ds, Ds, Ds, Ds, Wo, Wo, Wo, Wo, Wo, Wo, Wo, Wo, Wo, Ds
Hh, Mm, Hh, Hh, Ww, Hh, Ww, Ww, Ww, Ww, Ds, Gg, Gs^Fp, Gg, Gg, Gg, Aa, Aa, Gg, Gg, Rp, Rp, Gs^Fp, Gs^Fp, Ss, Ss, Ss, Ss, Gs^Fp, Gs^Fp, Gg, Gg, Ds, Wo, Ds, Ds, Ds, Ds, Ds, Ds, Ds, Ds
Gg, Gll^Fmf, Gs^Fp, Gs^Fp, Ww, Ww, Ww, Ww, Ww, Ww, Gg, Gg, Gs^Fp, Gg, Gg, Gg, Aa, Gg, Gg, Gg, Rp, Gg, Gs^Fp, Gg, Gs^Fp, Gg^Emf, Gs^Fp, Gs^Fp, Gg^Em, Gg^Em, Gs^Fp, Gg, Ds, Ds, Ds, Gg, Gg, Gs^Fp, Gs^Fp, Gg^Fet, Ds, Gs^Fp
Gg, Gll^Fmf, Gs^Fp, Gs^Fp, Gg^Vh, Ww, Ww, Ww, Ww, Ww, Gg, Gg, Gs^Fp, Gg, Gg^Em, Gg^Em, Gg^Em, Gg, Rr, Rr, Gg, Gs^Fp, Gs^Fp, Gs^Fp, Gs^Fp, Gs^Fp, Gs^Fp, Gg, Gg^Em, Gg, Gg, Gg, Gg, Gs^Fp, Gg, Gg, Gg, Gg, Gg, Gg, Gg, Gs^Fp
Gg, Gg, Gg, Gg, Gg, Aa, Ww, Ww, Ww, Gg, Gs^Fp, Gs^Fp, Gg, Gg, Gg, Gg^Em, Gg, Gg, Rr, Gs^Fp, Gs^Fp, Gs^Fp, Hh, Gs^Fp, Gs^Fp, Gs^Fp, Gg, Gg, Gg, Gg^Em, Gg, Gg, Gs^Fp, Gg^Efm, Gg^Efm, Gg, Aa, Aa, Gg, Gg, Gg, Gg
Gg, Gg, Gg, Gg, Gg, Aa, Aa, Ww, Aa, Gg, Gg, Gg, Aa, Ds, Ds, Gg, Gg^Vh, Gg, Rr, Gs^Fp, Gs^Fp, Hh, Hh, Hh, Gg, Gg, Gg, Hh, Ww, Gg, Ww, Gg^Vh, Gg, Gg^Efm, Gg^Efm, Gg, Aa, Aa, Gg, Gg, Gg, Gg
Gg, Gg, Aa, Aa, Aa, Aa, Ww, Ww, Gg, Gg, Gg, Ds, Wo, Wo, Ds, Gg, Rr, Rr, Gg, Gs^Fp, Hh, Hh, Hh, Gg, Gg, Hh, Mm, Ww, Ww, Ww, Ww, Hh, Gg, Gg^Efm, Gg, Aa, Aa, Aa, Aa, Gg, Gg, Gg
Rr, Aa, Aa, Aa, Aa, Aa, Ww, Ww, Gg, Gg, Wo, Wo, Wo, Wo, Wo, Ds, Rr, Gg, Gs^Fp, Gll^Fmf, Gs^Fp, Gs^Fp, Gs^Fp, Gg, Gg^Vh, Ww, Ww, Ww, Ww, Ww, Ww, Ww, Gg, Gg, Gg, Aa, Aa, Aa, Gg, Gg, Gs^Fp, Gs^Fp
Rr, Aa, Aa, Aa, Aa, Aa, Ww, Ww, Ww, Wo, Ds, Ds, Ds, Ds, Rr, Rr, Gg, Gg, Gs^Fp, Gs^Fp, Gs^Fp, Gs^Fp, Gs^Fp, Gs^Fp, Gs^Fp, Ww, Ww, Ww, Ww, Ww, Ww, Ww, Gg^Efm, Gg^Efm, Gg^Efm, Gg^Efm, Aa, Aa, Ww, Gg, Ww, Ww
Gg, Aa, Aa, Aa, Aa, Aa, Gg, Gg, Gs^Fp, Gs^Fp, Ds, Aa^Fpa, Gs^Fp, Rr, Gs^Fp, Gs^Fp, Gg, Gg, Gs^Fp, Gs^Fp, Gg^Fet, Gs^Fp, Gs^Fp, Gs^Fp, Gs^Fp, Ww, Ww, Ww, Ww, Ww, Ww, Gg, Gg^Efm, Gg^Efm, Gg^Efm, Gg^Efm, Aa, Ai, Aa, Ww, Ww, Ww
Rr, Aa, Aa, Gg, Rr, Gg, Gg, Gs^Fp, Gs^Fp, Gs^Fp, Gs^Fp, Gs^Fp, Gs^Fp, Rr, Gs^Fp, Gs^Fp, Gs^Fp, Gg, Gs^Fp, Gs^Fp, Gs^Fp, Gs^Fp, Gll^Fmf, Gs^Fp, Ww, Ww, Ww, Ww, Ww, Ww, Gg^Efm, Gg, Gg^Efm, Gg^Efm, Gg^Efm, Gg^Efm, Ww, Ai, Aa, Gg, Gg, Gs^Fp
Gg, Rr, Rr, Rr, Gg, Rr, Rr, Gg^Ve, Gs^Fp, Gll^Fmf, Gs^Fp, Gd^Fetd, Gs^Fp, Rr, Gs^Fp, Gg^Fet, Gs^Fp, Gll^Fmf, Gs^Fp, Gs^Fp, Gs^Fp, Gs^Fp, Gs^Fp, Gs^Fp, Gg, Ww, Ww, Ww, Ww, Gg, Gg, Gg^Efm, Gg, Gg, Ww, Ww, Ww, Aa, Aa, Gg, Gg, Gg
Gg, Ds, Ds, Ds, Gg, Gg, Rr, Gs^Fp, Gs^Fp, Gg, Gg, Gg, Rr, Rr, Gs^Fp, Gs^Fp, Gs^Fp, Gs^Fp, Gs^Fp, Gs^Fp, Gs^Fp, Gd^Fetd, Gs^Fp, Gs^Fp, Ww, Ww, Ww, Ww, Ww, Gg, Gg, Gg^Efm, Ww, Ww, Aa, Ai, Aa, Gg, Aa, Aa, Aa, Gg
Wo, Wo, Wo, Ds, Gg, Gg, Gg, Rr, Rr, Gg, Aa^Fda, Aa, Rr, Gg, Gs^Fp, Gg^Ve, Gg, Gg, Gs^Fp, Gs^Fp, Gs^Fp, Gs^Fp, Gs^Fp, Gg, Ww, Aa, Aa, Gg, Gg, Gs^Fp, Gg, Gg, Gg, Ww, Ww, Aa, Hh, Ha, Ha, Ha, Aa, Aa
Wo, Wo, Wo, Wo, Ds, Ds, Ds, Gg, Rr, Aa^Fda, Aa^Fda, Aa, Rr, Gg, Gg, Gs^Fp, Gg, Gg^Emf, Gs^Fp, Gll^Fmf, Gs^Fp, Gs^Fp, Gs^Fp, Gg, Ww, Aa, Gg, Ds, Ds, Gg, Ch, Ch, Ch, Ww, Gg^Vh, Hh, Ha, Mm, Mm, Ha, Ha, Gg
Wo, Wo, Wo, Wo, Wo, Wo, Ds, Ds, Aa, Aa^Fda, Aa, Gg, Rr, Gg, Gg, Gg, Gg, Gs^Fp, Gs^Fp, Gs^Fp, Gs^Fp, Gs^Fp, Gs^Fp, Ww, Ww, Gg, Gg, Gg, Ds, Gg, Ch, 3 Kh, Ch, Ww, Hh, Ww, Ww, Mm, Mm, Mm, Aa^Fpa, Gg
Wo, Wo, Wo, Wo, Wo, Ds, Aa, Gg, Gg, Aa, Rr, Rr, Gg, Gg, Gg, Gg^Es, Gg, Gg, Gll^Fmf, Gs^Fp, Gs^Fp, Gs^Fp, Gg, Gg^Vh, Ww, Gg, Gg^Es, Gg, Gg, Ch, Ch, Ch, Gg, Ww, Ww, Ww, Ww, Ww, Mm, Mm, Aa^Fpa, Aa^Fpa
Wo, Wo, Wo, Wo, Ds, Gg, Gg, Gg, Gg, Gg, Rr, Ch, Ch, Ch, Gs^Fp, Gg, Gg, Gg, Gs^Fp, Gg^Emf, Gs^Fp, Gs^Fp, Gg, Gg, Gg, Ww, Ww, Gg^Es, Gg, Gg, Aa, Gg, Gg, Ww, Ww, Ww, Ww, Ww, Ww, Hh, Aa^Fpa, Gs^Fp
Wo, Wo, Wo, Wo, Ds, Gg, Gg, Gg, Gg^Es, Gg, Rr, Ch, 2 Kh, Ch, Gg, Gg, Gg, Gs^Fp, Gs^Fp, Gg, Gll^Fmf, Gs^Fp, Gg, Gg, Gg, Ww, Gg, Gg, Gg, Aa, Aa, Aa, Hh, Hh, Ww, Ww, Ww, Ww, Aa^Fpa, Aa^Fpa, Gg, Gs^Fp
Ds, Wo, Wo, Wo, Ds, Gg, Gg, Gg^Es, Gg, Gg, Ch, Ch, Ch, Rr, Rr, Rr, Rr, Rr, Rr, Gs^Fp, Gg, Gs^Fp, Gg, Gg, Rr, Ww, Gg, Gg, Gg, Aa, Aa, Aa, Ha, Mm, Ww, Ww, Ww, Hh, Aa^Fpa, Gs^Fp, Gg^Vh, Ss
Gs^Fp, Ds, Wo, Wo, Ds, Gg, Gg^Vh, Gg, Gg, Gg, Gg, Gg, Gg, Aa, Aa, Gg^Em, Gg^Em, Aa^Fpa, Aa^Fpa, Rr, Rr, Gs^Fp, Rr, Rr, Ww, Ww^Bw\, Rr, Rr, Rr, Aa, Ha, Ha, Mm, Mm, Mm, Mm, Ha, Aa^Fpa, Gs^Fp, Ss, Ss, Ss
Gg, Ds, Gg, Ds, Gg, Gg, Gg, Gg, Gg, Gg^Es, Gg, Gg, Aa, Aa, Aa, Gg^Em, Gg^Em, Aa^Fpa, Aa^Fpa, Gll^Fmf, Gs^Fp, Rr, Gg, Gg, Ww, Ww, Gg^Em, Gg^Em, Aa, Aa, Aa, Ha, Ha, Ha, Ha, Ha, Aa^Fpa, Aa^Fpa, Gs^Fp, Ds, Wo, Wo
Aa, Aa, Aa, Aa, Aa, Aa, Aa, Gg, Gg, Gg^Es, Gg, Gg, Aa, Aa, Aa, Gg, Gg^Em, Aa^Fpa, Gs^Fp, Gg^Fet, Gs^Fp, Gs^Fp, Gg, Gg^Vh, Ww, Wo, Gg, Gg^Em, Gg^Em, Aa, Gg^Em, Rr^Em, Rr, Aa^Fma, Ha, Ha, Aa^Fpa, Gd^Fetd, Gs^Fp, Ds, Wo, Wo
Aa, Aa, Aa, Aa, Aa, Aa, Aa, Gg, Gg, Gg, Gg, Gg, Gg, Gg, Gg, Gg, Gg, Aa^Fpa, Gg, Gg, Gg, Gg, Gg, Ds, Ds, Wo, Ww, Gg, Gg, Gg^Em, Gg, Gg^Em, Gg, Rr, Rr, Rr, Gs^Fp, Gs^Fp, Gs^Fp, Ss, Ss, Ds
