Hh, Hh, Gll^Fp, Gll^Fp, Gll^Fp, Gll^Fp, Gll^Fp, Gg, Gg, Hh, Gg, Hh, Gg, Gg, Gg, Hh, Gg, Gg, Gg, Gg, Gg, Hh, Hh, Hh, Gg, Hh, Gg, Hh, Hh, Hh, Hh, Hh
Gg, Gll^Fp, Gll^Fp, Gll^Fp, Gll^Fp, Gll^Fp, Gll^Fp, Gg, Gg, Gg, Gg, Gg, Gg, Gg, Gg, Gg, Ce, Ce, Ce, Gg, Gg, Hh, Gg, Gg, Rp, Rp, Gg, Gg, Gg, Hh, Gg, Hh
Gg, Gll^Fp, Gll^Fp, Gll^Fp, Gll^Fp, Gll^Fp, Gll^Fp, Gll^Fp, Gll^Fp, Gg, Gg, Gg, Gg, Gg, Gg, Ce, Ce, 1 Ke, Gg, Gg, Gg, Gg, Gg, Gg, Rp, Gg, Gg, Gg, Gg, Gg, Gg, Gg
Gg, Gll^Fp, Gll^Fp, Gll^Fp, Gll^Fp, Gll^Fp, Gll^Fp, Gll^Fp, Gll^Fp, Gll^Fp, Gll^Fp, Gg, Gg, Gg, Gg^Es, Ce, Ce, Gg, Gg, Gg, Gg, Gg, Rp, Rp, Gg, Gg, Gg, Gg, Gg, Gg, Gg, Gg
Gll^Fp, Gll^Fp, Gll^Fp, Gll^Fp, Gll^Fp, Gll^Fp, Gll^Fp, Gll^Fp, Gll^Fp, Gll^Fp, Gll^Fp, Gg, Gg, Gg, Gg, Gg, Gg, Gg, Gg, Gg^Es, Gg, Gg, Rp, Gg, Gg, Gg, Gs^Vl, Gg, Gg, Gg^Es, Gg, Gg
Gll^Fp, Gll^Fp, Rp, Gll^Fp, Gg^Ve, Gll^Fp, Gll^Fp, Gll^Fp, Gll^Fp, Gll^Fp, Gll^Fp, Gg, Gg, Gg, Gg, Gg, Gg, Gg, Gg, Gg, Rp, Rp, Gg, Gg, Gll^Fp, Gll^Fp, Gll^Fp, Gll^Fp, Gll^Fp, Gg, Gg, Gg
Rp, Rp, Gll^Fp, Rp, Rp, Gll^Fp, Rp, Gll^Fp, Gll^Fp, Gll^Fp, Gll^Fp, Gll^Fp, Gll^Fp, Gg, Gg, Gg^Em, Gg, Gg, Rp, Rp, Gg, Gg, Gll^Fp, Gg, Gll^Fp, Gll^Fp, Gll^Fp, Gll^Fp, Gll^Fp, Gll^Fp, Gll^Fp, Gg
Gll^Fp, Gll^Fp, Gll^Fp, Gll^Fp, Gll^Fp, Rp, Gll^Fp, Rp, Rp, Gll^Fp, Gll^Fp, Gll^Fp, Gll^Fp, Gg, Gg, Gg, Rp, Rp, Gg, Gg, Gg, Gll^Fp, Gll^Fp, Gll^Fp, Hh^Vhh, Gll^Fp, Gll^Fp, Gll^Fp, Gll^Fp, Gll^Fp, Gll^Fp, Gll^Fp
Gll^Fp, Gll^Fp, Gll^Fp, Gll^Fp, Gll^Fp, Gll^Fp, Gll^Fp, Gll^Fp, Gll^Fp, Rp, Gll^Fp, Gll^Fp, Gll^Fp, Gg, Gg, Gg, Rp, Gg, Gg, Gg, Gg^Em, Gll^Fp, Gll^Fp, Gll^Fp, Hh, Hh, Hh, Hh, Hh, Gll^Fp, Gll^Fp, Gll^Fp
Gg, Gll^Fp, Gll^Fp, Gll^Fp, Gll^Fp, Gll^Fp, Gll^Fp, Gll^Fp, Gg, Rp, Rp, Gll^Fp, Gg, Gg, Rp, Rp, Gg, Gg, Gg, Gg, Gg, Gg, Gg, Gg, Gll^Fp, Hh, Hh, Hh, Hh, Hh, Hh, Hh
Gg, Gll^Fp, Ww, Gll^Fp, Ww, Gll^Fp, Gll^Fp, Gll^Fp, Gg, Gg, Gg, Rp, Rp, Rp, Gg^Efm, Gg^Efm, Gg^Efm, Gg, Gg, Gg, Gg, Gg, Gg, Gll^Fp, Gll^Fp, Gll^Fp, Hh, Hh, Hh, Hh, Hh, Hh
Gll^Fp, Ww, Gll^Fp, Ww, Gll^Fp, Ww, Ww, Ww, Ww, Gg, Ww, Gg, Rp, Gg, Gg^Efm, Gg^Efm, Gg, Gg, Gll^Fp, Gg, Hh^Vhh, Hh, Hh, Gll^Fp, Gll^Fp, Gll^Fp, Hh, Hh, Hh, Hh, Hh, Hh
Gll^Fp, Gll^Fp, Gll^Fp, Gll^Fp, Gll^Fp, Gll^Fp, Gll^Fp, Ww, Ww, Ww, Ww, Ww, Rp, Gg, Gg, Gg, Gll^Fp, Gll^Fp, Gll^Fp, Gll^Fp, Hh, Hh, Hh, Gll^Fp, Gll^Fp, Gll^Fp, Hh, Hh, Hh, Hh, Hh, Hh
Gll^Fp, Gll^Fp, Gll^Fp, Gll^Fp, Gll^Fp, Gll^Fp, Gll^Fp, Gs^Vh, Ww, Ww, Ww, Ww, Gs^Vh, Rp, Gg, Gg, Gll^Fp, Gll^Fp, Gll^Fp, Gll^Fp, Hh, Hh, Hh, Hh, Hh, Hh, Hh, Hh, Hh, Hh, Hh, Hh
Gg, Gll^Fp, Gll^Fp, Gll^Fp, Gll^Fp, Gll^Fp, Gll^Fp, Ww, Ww, Wo, Wo, Ww, Ww, Rp, Gg, Gg, Gll^Fp, Gll^Fp, Gll^Fp, Hh, Hh, Hh, Hh, Hh, Hh, Hh, Hh, Hh, Hh, Hh, Hh, Hh
Hh, Gll^Fp, Gll^Fp, Gll^Fp, Gll^Fp, Gll^Fp, Hh, Ww, Ww, Ww, Ww, Ww, Ww, Rp, Gg, Gg, Gll^Fp, Gll^Fp, Gll^Fp, Hh, Mm, Mm, Mm, Hh, Mm, Hh, Mm, Hh, Hh, Hh, Hh, Hh
Hh, Gll^Fp, Gll^Fp, Gll^Fp, Gll^Fp, Gll^Fp, Mm, Mm, Mm, Ww, Ww, Ww, Ww, Rp, Rp, Gg, Gll^Fp, Gll^Fp, Gll^Fp, Hh, Mm, Mm, Mm, Mm, Mm, Mm, Mm, Mm, Hh, Hh, Hh, Hh
Hh, Hh, Hh, Gll^Fp, Hh, Hh, Mm, Mm, Mm, Gg, Gg, Gg^Vwm, Gg, Ww, Rp, Gg, Gll^Fp, Gll^Fp, Gll^Fp, Hh, Hh, Mm, Mm, Mm, Mm, Mm, Mm, Mm, Hh, Hh, Hh, Hh
Hh, Hh, Hh, Hh, Hh, Mm, Mm, Mm, Mm, Mm, Hh, Hh, Gg, Ww, Ww^Bsb|, Gg, Gg, Gll^Fp, Gll^Fp, Gll^Fp, Hh, Hh, Mm, Mm, Mm, Mm, Mm, Hh, Mm, Hh, Hh, Hh
Hh, Hh, Hh, Hh, Mm, Mm, Mm, Mm, Mm, Mm, Hh, Hh, Hh, Hh, Rp, Ww, Ww, Gg, Gg^Efm, Gll^Fp, Gll^Fp, Hh, Hh, Mm, Hh, Hh, Mm, Mm, Mm, Mm, Mm, Hh
Hh, Hh, Hh, Mm, Mm, Mm, Mm, Mm, Mm, Mm, Mm, Mm, Mm, Rp, Gg^Fet, Gg, Ww, Gg, Gg^Efm, Gll^Fp, Gll^Fp, Gll^Fp, Hh, Hh, Mm, Mm, Mm, Mm, Mm, Mm, Hh, Hh
Hh, Hh, Mm, Mm, Mm, Mm, Mm, Mm, Mm, Mm, Mm, Mm, Mm, Rp, Rp, Ww, Gg^Vwm, Gg, Gg^Efm, Gll^Fp, Gll^Fp, Hh, Hh, Mm, Mm, Mm, Mm, Mm, Mm, Mm, Mm, Hh
Hh, Mm, Mm, Mm, Mm, Mm, Hh, Mm, Mm, Mm, Mm, Mm, Hh, Hh, Rp, Ww, Ww, Gg, Gg, Gg^Efm, Gll^Fp, Gll^Fp, Hh, Hh, Hh, Mm, Mm, Mm, Mm, Mm, Mm, Mm
Mm, Mm, Mm, Mm, Hh^Vhh, Hh, Hh, Hh, Hh, Hh, Hh, Hh, Gg, Gg, Rp, Hh, Rp, Wwf, Rp, Gg, Rp, Gll^Fp, Gg^Efm, Hh, Hh, Mm, Mm, Hh^Vhh, Mm, Mm, Mm, Mm
Mm, Mm, Mm, Mm, Hh, Gg^Efm, Hh, Cha, Cha, Cha, Cha, Hh, Rp, Rp, Gg, Rp, Gg, Wwf, Gg, Rp, Hh, Rp, Rp, Rp, Rp, Hh, Ch, Hh, Hh, Mm, Mm, Mm
Mm, Mm, Mm, Mm, Gg^Efm, Gg^Efm, Gg^Efm, 2 Kha, Cha, Cha, Hh, Rp, Hh, Gg, Mm, Mm, Mm, Ww, Mm, Hh, Hh, Gg^Efm, Gg^Efm, Gg^Efm, Gg^Efm, Ch, Ch, Ch, Hh, Mm, Mm, Mm
Mm, Mm, Mm, Hh, Hh, Gg^Efm, Gg^Efm, Hh, Hh, Cha, Hh, Hh, Hh, Hh, Mm, Mm, Mm, Ww, Ww, Mm, Mm, Hh, Hh, Gg^Efm, Hh, 3 Kh, Ch, Ch, Hh, Mm, Mm, Mm
Mm, Mm, Mm, Hh, Hh, Mm, Hh, Hh, Hh, Hh, Mm, Mm, Mm, Hh^Vhh, Mm, Mm, Mm, Mm, Ww, Mm, Mm, Hh^Vhh, Mm, Hh, Mm, Hh, Hh, Hh, Mm, Mm, Mm, Mm
Hh, Hh, Hh, Mm, Mm, Mm, Mm, Mm, Hh, Mm, Mm, Mm, Mm, Mm, Hh, Mm, Hh, Ww, Mm, Mm, Mm, Mm, Mm, Mm, Mm, Mm, Mm, Gg^Fet, Mm, Mm, Mm, Mm
Hh, Hh, Hh, Mm, Mm, Mm, Mm, Mm, Hh, Mm, Mm, Mm, Hh, Hh, Hh, Hh, Ww, Ww, Mm, Mm, Hh, Mm, Mm, Mm, Mm, Mm, Mm, Mm, Mm, Mm, Mm, Mm
Hh, Hh, Hh, Hh, Mm, Hh, Mm, Mm, Mm, Mm, Mm, Mm, Mm, Hh, Hh, Hh, Ww, Mm, Mm, Mm, Hh, Hh, Hh, Mm, Hh, Mm, Mm, Mm, Mm, Mm, Hh, Hh
Hh, Hh, Hh, Hh, Hh, Hh, Mm, Mm, Mm, Mm, Mm, Mm, Hh, Hh, Hh, Hh, Ww, Hh, Hh, Hh, Hh, Hh, Hh, Hh, Hh, Hh, Hh, Mm, Hh, Hh, Hh, Hh
