Ms, Ms, Ms, Ms, Ms, Ms, Ms, Ms, Ms, Ms, Ms, Ms, Ms, Ms, Ms, Ms, Ms, Ms, Ms, Ms, Ms, Ms, Ms, Ms, Ms, Ms, Ms, Ms, Ms, Ms, Ms, Ms
Ms, Ms, Ms, Ms, Ms, Ms, Ms, Ms, Ms, Ms, Ms, Ms, Ms, Ms, Ms, Ms, Ms, Ms, Ms, Ms, Ms, Ms, Ms, Ms, Ms, Ms, Ms, Ms, Ms, Ms, Ms, Ms
Ms, Ms, Ms, Ms, Qxua, Qxua, Qxua, Ms, Qxua, Ms, Ms, Ms, Ms, Ms, Ms, Ms, Qxua, Ms, Ms, Ms, Qxua, Qxua, Qxua, Ms, Ms, Ms, Ms, Ms, Ms, Ms, Ms, Ms
Ms, Ms, Ms, Ms, Qxua, Qxua, Qxua, Qxua, Qxua, Qxua, Qxua, Ms, Ms, Ms, Qxua, Qxua, Qxua, Qxua, Qxua, Qxua, Qxua, Qxua, Qxua, Qxua, Qxua, Qxua, Qxua, Qxua, Ms, Ms, Ms, Ms
Ms, Ms, Ms, Ms, Qxua, Qxua, Qxua, Qxua, Qxua, Qxua, Qxua, Qxua, Qxua, Qxua, Qxua, Qxua, Aa, Qxua, Qxua, Qxua, Qxua, Qxua, Qxua, Qxua, Aa, Qxua, Qxua, Qxua, Qxua, Ms, Ms, Ms
Ms, Ms, Ms, Ms, Ms, Qxua, Qxua, Qxua, Qxua, Qxua, Qxua, Qxua, Qxua, Qxua, Qxua, Aa, Aa^Fma, Aa, Ai, Qxua, Qxua, Qxua, Qxua, Aa, Aa^Fma, Aa^Fma, Aa^Fma, Qxua, Qxua, Ms, Ms, Ms
Ms, Ms, Ms, Ms, Ms, Ms, Ms, Qxua, Qxua, Qxua, Qxua, Qxua, Qxua, Qxua, Qxua, Aa, Aa^Fma, Aa^Fma, Ai, Aa^Fma, Qxua, Qxua, Qxua, Aa, Aa^Edb, 6 Aa^Vca, Aa^Fma, Qxua, Ms, Ms, Ms, Ms
Ms, Ms, Ms, Ms, Ms, Ms, Ms, Qxua, Qxua, Qxua, Qxua, Qxua, Qxua, Qxua, Qxua, Qxua, Ai, Ai, Aa^Fma, Aa^Fma, Aa^Fma, Qxua, Qxua, Qxua, Qxua, Aa^Fma, Qxua, Qxua, Ms, Ms, Ms, Ms
Ms, Ms, Ms, Ms, Ms, Ms, Qxua, Qxua, Qxua, Qxua, Qxua, Qxua, Qxua, Qxua, Aa^Fma, Ai, 5 Aa^Vla, Ai, Aa^Fma, Aa^Fma, Aa, Qxua, Qxua, Qxua, Qxua, Qxua, Qxua, Qxua, Qxua, Ms, Ms, Ms
Ms, Ms, Ms, Ms, Ms, Ms, Qxua, Qxua, Qxua, Qxua, Qxua, Qxua, Aa^Fma, Aa^Fma, Aa^Fma, Ai, Ai, Ai, Aa^Fma, Aa, Qxua, Qxua, Qxua, Qxua, Qxua, Qxua, Qxua, Qxua, Qxua, Ms, Ms, Ms
Ms, Ms, Ms, Ms, Qxua, Qxua, Qxua, Qxua, Qxua, Qxua, Aa, Qxua, Aa^Fma, Aa^Fma, Ai, Ai, Aa^Fma, Aa^Fma, Aa, Aa, Qxua, Qxua, Qxua, Qxua, Qxua, Qxua, Qxua, Qxua, Qxua, Ms, Ms, Ms
Ms, Ms, Ms, Qxua, Qxua, Qxua, Qxua, Qxua, Qxua, Aa, Aa^Fma, Aa^Edb, Ai, Ai, Qxua, Qxua, Qxua, Qxua, Qxua, Qxua, Qxua, Qxua, Qxua, Qxua, Qxua, Qxua, Qxua, Qxua, Ms, Ms, Ms, Ms
Ms, Ms, Ms, Qxua, Qxua, Qxua, Qxua, Qxua, Qxua, Aa, Aa, Aa^Fma, Ai, Qxua, Ai, Qxua, Aa^Fma, Aa^Edb, Aa^Fma, Qxua, Qxua, Qxua, Qxua, Qxua, Qxua, Qxua, Qxua, Qxua, Ms, Ms, Ms, Ms
Ms, Ms, Ms, Qxua, Qxua, Qxua, Qxua, Qxua, Qxua, Qxua, Aa, Aa^Fma, Ai, Ai, Ai, Ai, Ai, Aa^Fma, Aa^Fpa, Qxua, Qxua, Qxua, Qxua, Qxua, Qxua, Qxua, Qxua, Qxua, Ms, Ms, Ms, Ms
Ms, Ms, Ms, Qxua, Qxua, Qxua, Qxua, Qxua, Qxua, Qxua, Qxua, Aa^Fma, 4 Aa^Vla, Ai, Ai, Ai, Aa^Fma, Aa^Fpa, Qxua, Qxua, Qxua, Qxua, Aa^Fpa, Aa^Fma, Aa^Fpa, Aa^Fma, Aa^Fma, Qxua, Ms, Ms, Ms, Ms
Ms, Ms, Ms, Qxua, Qxua, Qxua, Qxua, Qxua, Qxua, Qxua, Qxua, Aa^Fma, Aa^Fma, Aa^Fma, Qxua, Aa^Fma, Qxua, Qxua, Qxua, Qxua, Qxua, Qxua, Aa^Fma, Aa^Fma, Aa^Fma, 8 Aa^Vaa, Aa^Fma, Qxua, Qxua, Ms, Ms, Ms
Ms, Ms, Ms, Ms, Qxua, Qxua, Qxua, Qxua, Qxua, Qxua, Qxua, Qxua, Qxua, Qxua, Qxua, Qxua, Qxua, Qxua, Qxua, Qxua, Qxua, Qxua, Qxua, Aa^Edb, Qxua, Aa^Fma, Qxua, Qxua, Qxua, Ms, Ms, Ms
Ms, Ms, Ms, Ms, Qxua, Qxua, Qxua, Qxua, Qxua, Qxua, Aa^Fpa, Qxua, Qxua, Qxua, Qxua, Qxua, Qxua, Qxua, Qxua, Qxua, Qxua, Qxua, Qxua, Qxua, Qxua, Qxua, Qxua, Qxua, Ms, Ms, Ms, Ms
Ms, Ms, Ms, Ms, Ms, Qxua, Qxua, Qxua, Aa^Fpa, Aa^Fpa, Aa^Fpa, Aa^Fpa, Aa^Fpa, Qxua, Qxua, Qxua, Qxua, Qxua, Aa^Fpa, Aa^Fpa, Aa^Fpa, Qxua, Aa^Vla, Qxua, Qxua, Qxua, Qxua, Qxua, Ms, Ms, Ms, Ms
Ms, Ms, Ms, Ms, Ms, Qxua, Qxua, Qxua, Aa^Fpa, Aa^Fpa, Aa^Fpa, Aa^Fpa, Ha, Ha, Qxua, Qxua, Qxua, Qxua, Ha, Ha, Ha, Aa^Fpa, Aa^Fpa, Aa^Fpa, Qxua, Qxua, Qxua, Qxua, Ms, Ms, Ms, Ms
Ms, Ms, Ms, Ms, Qxua, Qxua, Qxua, Qxua, Qxua, Aa^Fpa, Aa^Fpa, Ha, Ms, Ha, Ha, Qxua, Ha, Ha, Ms, Ms, 3 Ms, Ha, Aa^Fpa, Aa^Fpa, Qxua, Qxua, Qxua, Qxua, Ms, Ms, Ms, Ms
Ms, Ms, Ms, Ms, Qxua, Qxua, Qxua, Qxua, Qxua, Qxua, Qxua, Ha, Ai, Ai, Ai, Ha, Ai, Ai, Ha, Ha, Ha, Ha, Qxua, Qxua, Qxua, Qxua, Qxua, Qxua, Ms, Ms, Ms, Ms
Ms, Ms, Ms, Ms, Qxua, Qxua, Qxua, Qxua, Aa^Fpa, Qxua, Aa^Fpa, Qxua, Ha, Ha, 2 Ai, Ai, Aa^Vla, Ai, Ms, Ha, Aa^Fpa, Qxua, Qxua, Qxua, Qxua, Qxua, Qxua, Ms, Ms, Ms, Ms, Ms
Ms, Ms, Ms, Ms, Qxua, Qxua, Qxua, Aa^Fpa, Aa^Fpa, Ha, Ms, Ms, Ha, Ai, Ha, Ha, Qxua, Ha, Ha, Ha, Aa^Fpa, Aa^Fpa, Aa^Fpa, Qxua, Qxua, Qxua, Qxua, Ms, Ms, Ms, Ms, Ms
Ms, Ms, Ms, Ms, Qxua, Qxua, Qxua, Aa^Fpa, Aa^Fpa, Ha^Vhha, Ha, Ha, Aa^Fpa, Ha, Qxua, Qxua, Qxua, Qxua, Qxua, Aa^Fpa, Aa^Fpa, 7 Ha^Vhha, Aa^Fpa, Qxua, Qxua, Qxua, Qxua, Qxua, Qxua, Ms, Ms, Ms
Ms, Ms, Ms, Ms, Aa, Qxua, Qxua, Aa^Fpa, Aa^Fpa, Ha, Ha, Ha, Qxua, Qxua, Qxua, Qxua, Qxua, Qxua, Qxua, Qxua, Qxua, Aa^Fpa, Qxua, Qxua, Qxua, Qxua, Qxua, Qxua, Qxua, Ms, Ms, Ms
Ms, Ms, Ha, Aa, Aa, Aa, Qxua, Qxua, Qxua, Aa^Fpa, Qxua, Qxua, Qxua, Qxua, Qxua, Qxua, Qxua, Qxua, Qxua, Qxua, Qxua, Qxua, Qxua, Qxua, Qxua, Qxua, Qxua, Qxua, Qxua, Ms, Ms, Ms
Ms, Ha, Cea, Cea, Cea, Aa, Aa, Qxua, Qxua, Qxua, Qxua, Qxua, Qxua, Qxua, Qxua, Qxua, Qxua, Qxua, Qxua, Qxua, Qxua, Qxua, Qxua, Qxua, Qxua, Qxua, Qxua, Qxua, Qxua, Qxua, Ms, Ms
Ms, Ha, Cea, Cea, 1 Kea, Cea, Cea, Aa, Aa, Qxua, Qxua, Qxua, Ms, Qxua, Qxua, Qxua, Qxua, Qxua, Qxua, Qxua, Qxua, Qxua, Qxua, Qxua, Qxua, Qxua, Qxua, Qxua, Qxua, Ms, Ms, Ms
Ha, Ha, Cea, Cea, Ha, Ha, Ha, Ha, Ms, Ms^Xm, Ms, Ms, Ms, Ms, Ms, Qxua, Ms, Qxua, Qxua, Qxua, Ms, Qxua, Ms, Qxua, Qxua, Qxua, Qxua, Qxua, Ms, Ms, Ms, Ms
Ms, Ha, Ha, Ha, Ms, Ms, Ms, Ms, Ms, Ms, Ms, Ms, Ms, Ms, Ms, Ms, Ms, Ms, Ms, Ms, Ms, Ms, Ms, Ms, Ms, Ms, Ms, Ms, Ms, Ms, Ms, Ms
Ms, Ms, Ms, Ms, Ms, Ms, Ms, Ms, Ms, Ms, Ms, Ms, Ms, Ms, Ms, Ms, Ms, Ms, Ms, Ms, Ms, Ms, Ms, Ms, Ms, Ms, Ms, Ms, Ms, Ms, Ms, Ms
