Hd, Hd, Hd, Hd, Hd, Hd, Hd, Gs, Hd^Edp, Dd, Hd, Hd, Dd, Dd, Hd, Hd, Hd, Ww, Gd, Hd, Hd, Hd, Mdd, Hd, Mdd, Mdd, Hd, Dd, Dd, Gll^Fmf, Gs, Gs, Dd^Ftd, Gd, Dd, Dd, Dd, Dd, Dd, Dd, Dd, Dd, Dd, Dd, Dd
Hd, Hd, Hd, Hd, Hd, Hd, Dd, Hd, Dd^Edp, Dd^Edp, Hd, Dd, Dd, Dd, Dd, Hd, Hd, Ww, Gd, Hd, Hd, Hd, Hd, Hd, Mdd, Mdd, Hd, Hd, Dd, Dd^Ftd, Dd^Ftd, Dd^Ftd, Dd^Ftd, Dd, Dd, Dd, Dd, Dd, Dd, Dd, Dd, Dd, Dd, Dd, Re
Hd, Hd, Hd, Hd, Hd, Dd, Dd^Edp, Dd^Edp, Dd, Dd, Dd, Dd, Dd, Dd^Vdt, Dd, Dd, Hd, Ww, Ww, Gd, Gd, Gd, Gd, Hd, Mdd, Mdd, Hd, Dd, Dd, Dd^Ftd, Dd^Ftd, Dd^Ftd, Dd, Dd, Gd, Gd, Dd, Dd, Dd, Dd, Re, Dd, Re, Re, Dd
Hd, Hd, Hd, Hd, Dd, Hd, Dd^Edp, Dd, Dd, Gd, Dd, Dd, Rd^Esd, Dd, Dd, Dd, Dd, Gd, Ww, Dd^Vda, Gd, Hd, Hd, Hd, Mdd, Mdd, Dd, Dd, Dd, Gd^Fts, Gd^Fts, Dd^Ftd, Dd, Dd, Dd, Dd, Re, Re, Re, Re, Dd, Re, Dd, Dd, Dd
Hd, Hd, Hd, Hd, Hd, Dd, Hd^Edp, Dd^Edp, Gd^Edp, Gd, Rd^Esd, Rd^Esd, Rd^Esd, Rd^Esd, Dd, Dd, Dd, Gd, Ww, Ww, Gd, Hd, Hd, Hd, Hd, Hd, Dd, Dd, Gd^Fts, Gd^Fts, Dd^Ftd, Gd^Fts, Dd^Vda, Dd, Dd, Dd, Re, Dd, Dd, Dd, Dd, Dd, Dd, Dd, Dd
Gll^Fdf, Hd, Dd, Hd, Dd, Hd, Hd^Edp, Dd^Edp, Dd, Gd, Dd, Rd^Esd, Dd, Dd, Dd, Dd, Dd, Gd, Gd, Ww, Gd, Hd, Hd, Hd, Hd, Dd, Dd, Dd, Gd^Fts, Gd^Fts, Gd^Fts, Gd^Fts, Gd^Fts, Dd, Re, Re, Dd^Ecf, Dd, Dd^Vda, Dd, Dd, Dd, Dd, Dd, Dd
Hd, Hd, Hd, Dd, Dd, Dd, Dd^Edp, Dd, Dd, Dd, Dd, Dd, Dd, Dd, Dd, Dd, Dd, Dd, Gd, Ww, Gd, Hd, Hd, Hd, Hd, Dd, Dd, Dd, Dd, Gd^Fts, Gd^Fts, Gd^Fts, Gd^Fts, Dd, Re, Dd, Dd, Gd, Dd, Dd, Dd, Dd, Dd, Dd, Dd
Gll^Edp, Hd, Hd, Dd, Dd, Dd, Dd, Dd, Dd, Dd, Dd, Dd, Dd^Esd, Dd, Dd, Dd, Gll^Edp, Dd, Gd, Ww, Gd, Dd, Dd, Dd^Vda, Hd, Hd, Dd, Dd, Dd, Dd, Dd, Dd, Re, Re, Dd, Dd, Dd, Dd, Dd, Dd, Dd, Dd, Dd, Dd, Dd
Hd, Hd, Dd, Dd, Rd, Dd, Rd, Dd, Dd, Dd, Dd^Esd, Dd^Esd, Dd^Esd, Dd^Esd, Dd, Dd, Gll^Edp, Dd, Gd, Ww, Gd, Gd, Dd, Dd^Es, Hd, Hd, Dd^Edt, Dd, Dd, Dd, Dd^Ecf, Dd, Re, Dd, Ce, Ce, Ce, Dd, Dd, Dd, Dd^Ecf, Dd, Dd, Dd, Dd
Hd, Hd, Dd, Rd, Rd^Edp, Rd, Rd, Dd^Ftd, Gll^Edp, Rd, Dd, Dd^Esd, Dd, Dd, Dd^Vda, Gll^Edp, Gll^Edp, Dd, Gd, Ww, Gd, Dd, Dd, Dd^Es, Hd, Hd, Dd^Vda, Dd^Edt, Dd, Dd, Re, Re, Dd, Dd, Ce, 2 Ke, Ce, Gd, Dd^Vda, Dd, Dd, Dd, Dd, Dd, Dd
Dd, Dd, Rd, Rd, Rd^Edp, Rd, Dd^Ftd, Dd^Ftd, Gll^Edp, Dd, Dd, Rd, Dd, Dd, Dd, Gll^Edp, Dd^Ftd, Gll^Edp, Gd, Ww, Ww, Gd, Dd, Dd, Dd^Es, Dd^Es, Dd, Dd, Dd, Dd, Re, Dd, Dd, Rd, Rd, Ce, Rd, Dd, Dd, Dd, Dd, Dd, Dd, Dd, Dd
Rd, Rd, Rd, Rd^Edp, Rd, Rd, Dd, Dd, Dd, Dd, Dd^Vda, Dd, Dd, Dd, Dd, Dd^Ftd, Dd^Ftd, Dd^Ftd, Gll^Edp, Gd, Ww, Gd, Dd, Dd, Dd, Dd, Dd, Dd, Re, Re, Dd, Dd, Dd, Dd, Dd, Rd, Dd, Dd, Dd, Dd, Dd, Dd, Dd, Dd, Dd
Rd, Rd^Edp, Rd, Rd, Rd, Rd, Dd, Dd, Dd, Dd, Hd, Dd, Dd, Dd, Dd, Dd^Ftd, Dd^Ftd, Dd^Ftd, Gll^Edp, Gd, Ww, Dd, Dd, Dd, Dd, Dd, Dd, Dd, Re, Dd, Dd, Dd, Dd, Rd, Dd^Ecf, Rd, Rd, Dd, Dd, Dd, Dd, Dd, Dd^Edb, Dd, Dd
Rd, Rd^Edp, Rd, Rd, Rd, Dd, Dd, Dd, Dd, Dd, Hd, Dd, Dd, Dd, Dd, Dd, Dd^Ftd, Dd^Vda, Dd, Dd, Ww^Bw/, Re, Re, Re, Re, Re, Re, Re, Dd, Dd, Dd, Dd^Vda, Dd^Edt, Dd, Rd, Rd, Rd, Rd, Rd, Dd, Dd, Dd, Dd^Edb, Dd, Dd
Rd, Rd, Rd, Rd, Dd, Dd, Dd, Dd, Dd, Dd, Hd, Hd, Dd, Dd, Dd, Dd, Dd^Ftd, Dd, Re, Re, Ww, Dd^Vda, Gd, Dd, Dd, Dd, Dd, Dd, Dd, Dd, Dd, Dd^Edt, Rd, Dd, Dd, Rd, Dd, Rd, Dd, Dd, Dd, Dd^Edb, Dd, Dd, Dd
Rd, Rd, Dd^Edp, Dd, Dd, Dd, Gll^Edp, Dd, Dd, Dd, Dd, Hd, Dd, Dd, Dd, Dd, Dd, Re, Gd, Gd, Ww, Ww, Gd, Dd, Dd^Eff, Dd, Rd, Dd, Dd, Rd, Rd, Dd, Dd, Dd, Re^Edpp, Re^Edpp, Re, Dd, Dd, Dd, Dd, Dd, Dd, Dd, Dd
Rd^Edp, Rd^Edp, Dd, Dd, Dd, Gll^Edp, Dd^Ftd, Dd^Ftd, Dd^Ftd, Dd, Dd, Dd, Dd, Dd, Dd, Dd, Re, Re, Gll^Edp, Dd, Dd, Ww, Gd, Dd, Dd, Dd^Eff, Dd, Dd, Dd, Dd, Dd, Dd, Dd, Re^Edpp, Re^Edpp, Re^Edpp, Dd, Dd, Re, Dd, Dd, Dd, Dd, Dd, Dd
Dd^Edp, Dd^Edp, Dd, Dd, Dd, Gll^Edp, Dd, Dd, Dd, Dd, Dd, Dd, Dd, Dd, Dd, Dd, Re, Gll^Edp, Gll^Edp, Gd, Dd, Ww, Ww, Gd, Gd, Dd, Dd, Dd, Re^Edpp, Re^Edpp, Re^Edpp, Dd, Dd, Dd, Dd, Gd, Re, Re, Dd, Dd, Dd, Dd, Dd, Dd, Dd
Dd, Dd^Edp, Dd^Edp, Dd, Dd, Dd, Dd, Dd, Dd, Rd, Dd, Gll^Edp, Rd, Dd, Dd, Dd, Re, Dd^Ftd, Dd^Ftd, Dd^Ftd, Gll^Edp, Dd, Ww, Ww, Gg^Vh, Dd, Gd, Dd, Dd, Re^Edpp, Dd, Dd, Dd, Gd^Fts, Dd, Dd, Re, Dd, Dd, Dd, Dd, Dd, Dd, Dd, Dd
Dd, Dd, Dd, Dd, Dd, Rd, Rd, Rd, Rd, Rd, Dd, Gll^Edp, Gll^Edp, Gll^Edp, Gll^Edp, Dd^Ftd, Re, Dd^Ftd, Dd^Ftd, Dd^Ftd, Gll^Edp, Rd, Gd, Ww, Ww, Gd, Ww, Gd, Gd, Dd^Eff, Dd^Eff, Dd, Dd, Gd^Fts, Gd^Fts, Gs^Vh, Re, Dd, Dd, Dd, Dd, Dd, Dd, Dd, Dd
Dd, Dd, Dd, Dd, Rd, Rd, Rd, Rd, Rd, Rd, Gll^Edp, Gll^Edp, Dd^Ftd, Gll^Edp, Dd^Vda, Gll^Edp, Re, Gll^Edp, Rd, Gll^Edp, Rd, Rd, Rd, Gd, Ww, Ww, Ww, Ww, Gd, Gs^Vh, Dd, Dd^Eff, Dd, Gd^Fts, Gd^Fts, Re, Gs, Gd^Fts, Gd^Fts, Dd, Dd, Dd, Dd, Gd^Fts, Dd
Dd, Dd, Dd, Rd, Dd, Rd, Rd, Dd, Dd^Ftd, Dd^Ftd, Dd^Ftd, Dd^Ftd, Dd^Ftd, Gll^Edp, Re, Re, Gll^Edp, Gll^Edp, Dd^Ftd, Rd, Rd, Rd, Rd, Gd, Gd, Ww, Gg^Vh, Ww, Ww, Gd, Dd, Dd, Dd, Gd^Fts, Re, Re, Gs, Gd^Fts, Gd^Fts, Dd, Dd, Dd, Dd, Gd^Fts, Gd^Fts
Dd^Ftd, Dd^Ftd, Dd^Ftd, Dd^Ftd, Dd, Dd, Dd, Dd, Dd^Ftd, Dd^Ftd, Dd^Ftd, Gll^Edp, Gll^Edp, Dd^Ftd, Re, Gs^Edp, Gll^Edp, Dd^Ftd, Dd^Ftd, Rd, Re^Esd, Re^Esd, Re^Esd, Rd, Re, Re, Re, Gd, Ww, Gd, Gd, Dd, Dd, Gd^Fts, Re, Gd^Fts, Gs, Gd^Fts, Gd^Fts, Gd^Fts, Dd, Dd, Dd, Gd^Fts, Gd^Fts
Dd^Ftd, Dd^Ftd, Dd^Ftd, Dd^Ftd, Dd^Ftd, Dd, Dd, Dd, Dd^Ftd, Dd^Ftd, Dd^Ftd, Gll^Edp, Dd, Gll^Edp, Re, Dd^Vdt, Dd, Gll^Edp, Dd, Re, Re, Re^Esd, Dd, Re, Gd^Fts, Gd^Fts, Re, Gd, Ww, Ww, Gg^Vl, Dd, Dd, Dd, Re, Gd^Fts, Gd^Fts, Gd^Fts, Gd^Fts, Dd, Dd, Dd, Gd^Fts, Gd^Fts, Gd^Fts
Dd^Ftd, Dd^Ftd, Dd^Ftd, Dd, Dd, Dd, Dd, Dd, Dd, Dd, Gd, Dd, Dd, Dd, Re, Dd, Re, Re, Re, Dd, Dd, Dd, Re, Re, Gd^Fts, Gd^Fts, Gd^Fts, Re, Gd, Ww, Ww, Gd, Re, Re, Gd^Fts, Gd^Fts, Gd^Fts, Gd^Fts, Gd^Fts, Dd, Dd, Gd^Fts, Gd, Gd^Fts, Gd^Fts
Dd^Ftd, Dd^Ftd, Dd^Ftd, Dd^Ftd, Dd^Ftd, Dd, Dd, Dd, Dd, Gd, Re, Gd, Re, Re, Dd^Esd, Re, Rd^Edb, Rd, Rd, Re, Re, Re, Rd, Dd, Gd^Fts, Dd^Ftd, Dd^Ftd, Re, Re, Gd, Ww^Bw/, Re, Rd, Gs, Gd^Fts, Gd^Fts, Gd^Fts, Dd, Dd, Dd, Gd^Fts, Dd, Gd, Gd^Fts, Gd^Fts
Dd, Dd, Dd, Dd^Ftd, Dd, Dd, Dd, Dd, Re, Re, Rd, Re, Rd, Rd, Rd, Rd, Rd^Edb, Rd, Rd, Dd, Rd, Rd, Rd, Dd, Gd^Fts, Dd^Ftd, Gd^Fts, Gd^Fts, Dd, Re, Wwf, Ds, Rd, Gs, Gd^Fts, Gd^Fts, Gd^Fts, Dd, Dd, Dd, Dd, Gd^Fts, Gd^Fts, Gd^Fts, Gd^Fts
Dd, Dd, Dd, Dd, Dd, Dd, Dd, Dd, Dd, Rd, Dd, Dd^Vdt, Rd, Rd, Rd, Rd, Rd, Rd^Edb, Dd, Dd, Rd, Rd, Dd, Dd, Gd^Fts, Gd^Fts, Gd^Fts, Dd^Ftd, Dd, Rd, Rd, Wwf, Ds, Rd, Dd, Dd, Gd^Fts, Dd, Dd, Dd, Dd, Dd, Dd, Gd^Fts, Gd^Fts
Dd, Dd, Dd^Edpp, Dd, Dd, Dd, Rd, Dd, Rd, Dd, Rd, Rd, Rd, Rd^Esd, Rd, Rd, Rd, Rd, Rd, Dd, Dd^Vdt, Dd, Dd, Dd, Dd, Dd^Ftd, Dd^Ftd, Dd^Ftd, Dd, Rd, Ds, Wwf, Ds, Rd, Rd, Dd, Gd^Fts, Dd, Dd, Dd, Dd^Es, Dd^Es, Dd, Dd, Dd
Dd, Dd, Dd, Dd^Edpp, Dd^Edpp, Rd, Dd, Dd^Edp, Dd^Edp, Rd^Edp, Dd^Edp, Rd, Ce, Rd, Rd, Rd^Esd, Rd, Dd^Esd, Dd, Dd, Dd, Dd, Dd, Rd, Dd, Dd, Dd, Dd, Dd, Ds, Ds, Wwf, Wwf, Rd, Rd, Dd, Dd, Dd, Dd, Dd, Dd, Dd^Es, Dd, Dd, Dd
Dd, Rd, Rd, Rd, Rd, Rd, Dd, Dd^Edp, Dd, Dd^Edp, Rd, Ce, 1 Ke, Ce, Rd, Rd, Rd, Dd, Rd, Rd, Dd, Dd, Rd, Dd, Dd, Dd, Dd, Dd, Dd^Edb, Ds, Ds, Ds, Wwf, Dd^Vda, Rd^Edt, Ds, Rd, Rd, Rd, Dd^Es, Dd^Es, Dd^Es, Dd, Dd, Dd
Rd, Rd, Rd, Rd, Rd, Dd, Re, Re, Rd, Rd, Rd, Ce, Ce, Ce, Rd, Rd, Dd, Rd, Rd, Dd^Edp, Dd^Edp, Rd, Dd, Dd, Dd, Dd, Dd, Dd, Dd^Edb, Ds, Ds, Ds, Wwf, Ds, Ds, Ds^Edt, Rd, Rd, Rd, Rd^Es, Rd^Es, Dd, Rd, Dd, Dd
Rd, Rd, Rd, Rd, Dd, Dd, Re, Dd, Dd, Rd, Dd, Rd, Dd, Rd, Dd, Dd, Dd, Dd, Dd, Dd, Dd, Dd, Dd, Dd, Ds, Dd, Ds, Ds^Edb, Ds^Edb, Dd, Dd^Edb, Ds, Ds, Wwf, Ds, Rd, Rd, Rd, Rd, Rd, Rd^Es, Rd, Rd, Rd, Dd
Re, Re, Re, Rd, Rd, Rd, Re, Dd, Dd^Edp, Dd, Dd, Dd, Dd, Rd, Dd^Esd, Dd^Esd, Ds, Ds, Ds, Ds, Ds, Dd, Dd^Vdt, Ds, Ds, Ds, Ds, Ds, Ds, Dd^Edb, Ds, Ds, Ds, Wwf, Wwt, Ds, Ds, Rd, Ds, Rd, Rd, Rd^Es, Rd, Rd, Rd
Gd, Gd, Dd, Re, Re, Re, Dd, Dd, Dd, Dd, Dd, Hd, Dd, Dd, Dd, Dd, Ds, Ds, Ds, Ds, Ds, Ds, Ds, Ds, Ds, Ds, Ds, Ds, Wwt, Ds, Wwt, Wwt, Wwt, Wwt, Wwt, Wwt, Ds, Ds, Ds, Wwt, Wwt, Rd, Rd, Rd, Rd
Gd, Gd, Dd, Dd, Dd, Dd^Esd, Dd, Hd, Hd, Hd, Hd, Hd, Hd, Hd, Hd, Dd, Dd, Ds, Ds^Es, Ds, Ds, Ds, Ds, Ds, Ds, Ds^Es, Wwt, Wwt, Wwt, Wwt, Wwt, Wwt, Wwt, Wwt, Wwt, Ds, Ds, Ds, Ds, Wwt, Wwt, Wwt, Wwt, Rd, Rd
Dd, Dd, Dd, Dd, Dd, Dd^Esd, Hd, Mdd, Mdd, Mdd, Hd, Hd, Hd, Mdd, Dd, Dd, Ds, Ds, Ds, Ds, Ds, Ds^Es, Ds, Ds, Ds, Wwt, Wwt, Wwt, Wwt, Wwt, Wwt, Wwt, Wwt, Wwt, Ds, Ds, Wwt, Wwt, Wwt, Wwt, Wwt, Wwt, Wwt, Wwt, Wwt
Dd, Dd, Dd, Hd, Dd, Hd, Hd, Mdd, Mdd, Mdd, Hd, Mdd, Hd, Hd, Dd, Ds, Ds, Ds, Ds, Ds, Ds, Ds, Ds^Es, Ds, Ds, Ds, Wwt, Wwt, Wwt, Wwt, Wwt, Wwt, Wwt, Ds, Ds^Esd, Ds, Ds, Wwt, Wwt, Wwt, Wwt, Wwt, Wwt, Wwt, Wwt
Hd, Hd, Hd, Hd, Hd, Mdd, Mdd, Mdd, Hd, Mdd, Rd^Edp, Hd, Dd, Dd, Dd, Ds, Dd^Vda, Ds, Ds, Ds^Es, Ds, Ds, Ds, Ds, Ds, Wwt, Wwt, Wwt, Wwt, Wwt, Wwt, Wwt, Ds, Ds^Esd, Ds^Esd, Ds^Esd, Ds, Wwt, Wwt, Wwt, Wwt, Wwt, Wwt, Wwt, Wwt
Mdd, Hd, Mdd, Hd, Mdd, Mdd, Mdd, Mdd, Hd, Hd, Rd^Edp, Rd^Edp, Rd^Edp, Rd^Edp, Ds, Ds, Rd, Rd, Rd, Ds, Rd, Rd, Ds, Ds, Ds, Ds, Ds, Wwt, Wwt, Wwt, Ds, Wwt, Ds, Rd, Dd^Vda, Ds^Esd, Ds, Wwt, Wwt, Wwt, Wwt, Wwt, Wwt, Wwt, Wwt
Mdd, Mdd, Mdd, Mdd, Mdd, Mdd, Hd, Mdd, Hd, Hd, Rd, Rd^Edp, Ds, Ds, Ds, Rd, Rd, Rd, Rd, Rd, Rd, Rd, Dd^Vda, Ds, Ds, Ds^Esd, Ds^Esd, Ds^Esd, Ds, Ds, Ds, Ds, Ww^Bw/, Rd, Dd^Ftd, Rd, Ds, Wwt, Wwt, Wwt, Wwt, Wwt, Wwt, Wwt, Wwt
Mdd, Mdd, Mdd, Mdd, Mdd, Mdd, Hd, Hd, Hd, Rd, Ds, Ds, Hd, Hd, Rd, Rd, Rd, Rd, Gd, Rd, Rd, Rd, Rd, Ds, Ds, Ds^Esd, Ds, Ds, Ds, Ds, Wo, Ds, Ds, Ds, Ds, Dd^Ftd, Ds, Wwt, Wwt, Wwt, Wwt, Wwt, Wwt, Wwt, Wwt
Mdd, Mdd, Mdd, Mdd, Mdd, Hd, Hd, Hd, Hd, Ds, Ds, Hd, Hd, Hd, Dd, Rd, Rd, Gd, Gd, Gd, Rd, Rd, Rd, Ds, Ds, Ds, Wo, Wo, Wo, Wo, Wo, Wo, Wo, Ds, Wo, Ds, Wwt, Wwt, Wwt, Wwt, Wwt, Wwt, Wwt, Wwt, Wwt
