Wo, Wo, Ww, Wo, Wo, Wo, Wo, Wo, Ww, Wo, Wwr, Wwt, Wwt, Wwt, Ds, Ds, Ds, Hd, Md, Md^Xm, Md^Xm, Md^Xm, Md^Xm, Md^Xm, Hd, Md, Wwrt, Wo, Wo, Wo, Wo, Wo, Wo, Wo, Wo
Wo, Ww, Ds, Ds, Wwt, Ww, Ww, Ww, Wwr, Wwr, Ds, Ds, Ds, Ds, Ds, Dd^Vda, Ds, Hd, Ds, Md, Hd, Md, Hd, Md, Wwrt, Wwrt, Wwrt, Wwt, Wo, Wo, Wo, Wo, Wo, Wo, Wo
Wo, Wwt^Vm, Ds, Ds, Ds, Ds, Ds, Ds, Ds, Wwr, Wwr, Wwt^Vm, Ww, Ds, Ds, Dd, Ds, Ds, Hd, Ds, Ds, Ds, Gs^Ft, Gs^Ft, Ds, Wwrt, Wwt^Vm, Wwrt, Wo, Wo, Wo, Wo, Wo, Wo, Wo
Wo, Ww, Ww, Ds, Dd, Dd, Chw, Ds, Ds, Wwr, Ww, Ww, Wo, Ww, Ww, Ds, Ds, Hd, Md, Md^Xm, Md^Xm, Gs^Vht, Ds, Gs^Ft, Ds, Ds, Ww, Wo, Wo, Wo, Wo, Wo, Wo, Wo, Wo
Wo, Ww, Ww, Ds, Dd, 2 Khw, Chw, Dd, Wwr, Wwr, Ww, Wo, Wo, Wo, Ww, Ds, Ds, Dd, Hd, Md^Xm, Md, Hd, Dd, Ds, Ds, Ww, Ww, Wo, Wo, Wo, Wo, Wo, Wo, Wo, Wo
Wo, Ww, Ww, Ds, Ds, Dd, Ds, Dd, Ds, Wwr, Wwr, Wo, Ww, Ww, Wwr, Ds, Ds, Dd^Do, Dd, Dd, Dd, Dd, Dd, Dd, Ww, Ww, Wo, Wo, Wo, Wo, Wo, Wo, Wo, Wo, Wo
Wo, Wo, Ww, Ww, Ww, Ds, Ds, Ds, Wwr, Wwr, Wwr, Ww, Wwr, Wwr, Wwr, Wwr, Wwr, Ds, Ds, Dd, Ds, Dd, Ww, Dd, Ds, Ww, Ww, Wo, Wo, Wo, Wo, Wo, Wo, Wo, Wo
Wo, Wo, Wo, Ww, Ww, Ww, Dd, Wwr, Wwr, Wwr, Wwr, Wwr, Ww, Wwr, Ww, Wwr, Ww, Ww, Ww, Ds, Ds, Dd, Dd, Dd^Dc, Dd, Ds, Ds, Ww, Ww, Wo, Wo, Wo, Wo, Wo, Wo
Wo, Wo, Ww, Ww, Ds, Ww, Dd, Wwr, Wwt^Vm, Ww, Ww, Ww, Wo, Ww, Wo, Wo, Wo, Wo, Wo, Ww, Ww, Ds, Dd, Dd, Dd, Dd^Vda, Ds, Ds, Ds, Ww, Ww, Wo, Wo, Wo, Wo
Wo, Wo, Ww, Ds, Dd, Ds, Dd, Ds, Dd, Ds, Ds, Ww, Ww, Wo, Wo, Wo, Ww, Wo, Wo, Wo, Ww, Ww, Ds, Dd, Dd, Ds, Dd, Ds, Ds, Ds, Ds, Ww, Ww, Wo, Wo
Wo, Ww, Ds, Dd, Dd, Dd, Ds, Dd, Dd, Dd, Dd, Ww, Ww, Wo, Ww, Ww, Wwt^Vm, Ww, Ww, Wo, Ww, Ww, Ds, Ds, Ds, Dd, Gs^Ft, Ds, Ds, Ds, Ds, Ds, Ww, Wo, Wo
Wo, Ww, Ds, Dd, Dd, Ds, Gs^Ft, Gs^Ft, Mm^Xm, Dd, Dd, Ds, Ww, Wo, Wo, Ww, Dd, Dd, Wwr, Wwr, Wwr, Ds, Ds, Dd, Dd, Gs^Ft, Ww^Ewf, Gs^Ft, Ds, Ds, Chw, Ds, Ww, Wo, Wo
Wo, Ww, Ww, Dd, Dd, Ds, Gs^Ft, Mm^Xm, Hh, Gs^Ft, Dd, Ds, Ds, Ww, Ww, Ww, Ww, Dd, Dd, Wwr, Wwr, Wwr, Ww, Dd, Ds, Dd, Dd, Ds, Ds, Ds, 1 Khw, Ds, Ww, Wo, Wo
Wo, Ww, Ww, Ds, Ds, Dd, Dd^Vda, Gs^Ft, Dd, Dd, Dd, Dd, Ds, Ww, Ww, Ww, Ww, Ww, Dd, Wwr, Ds, Ww, Ww, Ww, Ww, Ds, Chw, Chw, Chw, Chw, Dd, Dd, Ww, Ww, Wo
Wo, Wo, Wo, Ww, Ww, Dd, Dd, Dd^Do, Dd, Dd, Ds, Ds, Wwr, Dd, Dd, Dd, Dd, Ds, Dd, Dd, Dd, Ds, Ww, Ww, Ww, Ww, Ww, Dd, Dd, Dd, Dd, Ww, Wo, Wo, Wo
Wo, Wo, Wo, Wo, Wo, Ww, Ww, Ds, Ww, Ww, Ww, Ww, Ww, Wwr, Wwr, Wwr, Wwr, Dd, Dd, Ss^Vhs, Ss, Ds, Ds, Ww, Dd, Ww, Wwt^Vm, Ds, Dd, Ds, Ww, Ww, Wo, Wo, Wo
Wo, Wo, Wo, Wo, Wo, Wo, Wo, Ww, Wo, Wo, Wo, Wo, Wo, Ww, Wo, Ww, Wo, Ds, Dd, Dd, Dd, Ds, Ds, Dd, Wo, Ds, Ds, Ds, Ds, Wo, Wo, Wo, Wo, Wo, Wo
